EEEEEEEEEEEEEEEEEEEEEEEEEEEEEE
ERHHHHHHHHHLRHHHHLRHHHHHHHHHLE
EVBBBBBBBBBVVBBBBVVBBBBBBBBBVE
EVBRHHLBRLBVVBRLBVVBRLBRHHLBVE
EVBDHHUBVVBDUBVVBDUBVVBDHHUBVE
EVBBBBSBVVBBBBVVBBBBVVBSBBBBVE
EVBRHHLBVDHHLBVVBRHHUVBRHHLBVE
EVBVRHUBDHHHUBVVBDHHHUBDHLVBVE
EVBVVBBBBBBBBBVVBBBBBBBBBVVBVE
EVBVVBRHHLERHHUDHHLERHHLBVVBVE
HUBDUBDHHUEDHHHHHHUEDHHUBDUBDH
EEBBBBBBEEEEEEEEEEEEEEBBBBBBEE
HLBRHHLBRLERHHEEHHLERLBRHHLBRH
EVBVEEVBVVEVEE34EEVEVVBVEEVBVE
EVBDHHUBVVEVEE12EEVEVVBDHHUBVE
EVBBBBBBVVEVEEEEEEVEVVBBBBBBVE
EVERHHLBVVEDHHHHHHUEVVBRHHLEVE
EVEDHLVBVVEEEEFEEEEEVVBVRHUEVE
EVEEEVVBDUEHHHLRHHHEDUBVVEEEVE
EDHLEVVBBBBBBBVVBBBBBBBVVERHUE
ERHUEVVBRHHHLBVVBRHHHLBVVEDHLE
EVEEEVVBVRHHUBDUBDHHLVBVVEEEVE
EVERHUVBVVBBBBPEBBBBVVBVDHLEVE
EVEDHHUBVVBRLBRLBRLBVVBDHHUEVE
EVBBBBBBVVBVVBVVBVVBVVBBBBBBVE
EVBRLBRHUVBVVBVVBVVBVDHLBRLBVE
EVBVVBDHHUBVVBDUBVVBDHHUBVVBVE
EVBVVBSBBBBVVBBBBVVBBBBSBVVBVE
EVBVDHHHHLBVDHHHHUVBRHHHHUVBVE
EVBDHHHHHUBDHHHHHHUBDHHHHHUBVE
EVBBBBBBBBBBBBBBBBBBBBBBBBBBVE
EDHHHHHHHHHHHHHHHHHHHHHHHHHHUE
EEEEEEEEEEEEEEEEEEEEEEEEEEEEEE