ERHHHHHHHHHHHHLRHHHHHHHHHHHHLE
EVBBBBBBBBBBBBVVBBBBBBBBBBBBVE
EVBRHHLBRHHHLBVVBRHHHLBRHHLBVE
EVBVEEVBVEEEVBVVBVEEEVBVEEVBVE
EVSDHHUBDHHHUBDUBDHHHUBDHHUSVE
EVBBBBBBBBBBBBBBBBBBBBBBBBBBVE
EVBRHHLBRLBRHHHHHHLBRLBRHHLBVE
EVBDHHUBVVBDHHLRHHUBVVBDHHUBVE
EVBBBBBBVVBBBBVVBBBBVVBBBBBBVE
EDHHHHLBVDHHLBVVBRHHUVBRHHHHUE
EEEEEEVBVRHHUBDUBDHHLVBVEEEEEE
EEEEEEVBVVEEEEEEEEEEVVBVEEEEEE
EEEEEEVBVVERHHEEHHLEVVBVEEEEEE
EHHHHHUBDUEVEE34EEVEDUBDHHHHHE
EEEEEEEBEEEVEE12EEVEEEBEEEEEEE
EHHHHHLBRLEVEEEEEEVERLBRHHHHHE
EEEEEEVBVVEDHHHHHHUEVVBVEEEEEE
EEEEEEVBVVEEEEFEEEEEVVBVEEEEEE
EEEEEEVBVVERHHHHHHLEVVBVEEEEEE
ERHHHHUBDUEDHHLRHHUEDUBDHHHHLE
EVBBBBBBBBBBBBVVBBBBBBBBBBBBVE
EVBRHHLBRHHHLBVVBRHHHLBRHHLBVE
EVBDHLVBDHHHUBDUBDHHHUBVRHUBVE
EVSBBVVBBBBBBBPBBBBBBBBVVBBSVE
EDHLBVVBRLBRHHHHHHLBRLBVVBRHUE
ERHUBDUBVVBDHHLRHHUBVVBDUBDHLE
EVBBBBBBVVBBBBVVBBBBVVBBBBBBVE
EVBRHHHHUDHHLBVVBRHHUDHHHHLBVE
EVBDHHHHHHHHUBDUBDHHHHHHHHUBVE
EVBBBBBBBBBBBBBBBBBBBBBBBBBBVE
EDHHHHHHHHHHHHHHHHHHHHHHHHHHUE