1111111111111111111111111111
1000000000000110000000000001
1011110111110110111110111101
1p111101111101101111101111p1
1011110111110110111110111101
1000000000000000000000000001
1011110110111111110110111101
1011110110111111110110111101
1000000110000110000110000001
111111011111x11x111110111111
xxxxx1011111x11x1111101xxxxx
xxxxx1011xxxxxxxxxx1101xxxxx
xxxxx1011x11111111x1101xxxxx
111111011x1xxxxxx1x110111111
xxxxxx0xxx1xxxxxx1xxx0xxxxxx
111111011x1xxxxxx1x110111111
xxxxx1011x11111111x1101xxxxx
xxxxx1011xxxxxxxxxx1101xxxxx
xxxxx1011x11111111x1101xxxxx
111111011x11111111x110111111
1000000000000110000000000001
1011110111110110111110111101
1011110111110110111110111101
1p00110000000SS00000001100p1
1110110110111111110110110111
1110110110111111110110110111
1000000110000110000110000001
1011111111110110111111111101
1011111111110110111111111101
1000000000000000000000000001
1111111111111111111111111111